   WE                          images/greenlight.png
NO      images/pillar.png



SO images/wood.png

C   0,255,255

EA images/greystone.png



F 216,197,150

11111111111111111111111
10000000000000000000001
10000000000000000000001
100000000S0000000000001
10000000000000000000001
10000000000000000000001
10000000000000000000001
10000011111000010101001
10000010001000000000001
10000010001000010001001
10000010001000000000001
10000011110000101010001
10000000000000000000001
10000000000000000000001
10000000000000000000001
10000000000000000000001
10000000000000000000001
10000000000000000000001
10000000000000000000001
11111111100000000000001
10010000100000000000001
10000010100000000000001
10010000100000000000001
10011111100000000000001
10000000000000000000001
10000000000000000000001
11111111111111111111111
