NO texture/rock.xpm
SO texture/wall.xpm
WE texture/wood.xpm
EA texture/q.xpm







F  35,32,150
C  32,23,31

1111111111111111111111111
1000000000110000000000001
1011000001110000000000001
10010000000000000000000011111111
1000000000000000000000000000001
10000000000000000000000000000001
10000000000011011000000000000001
10000000000000000000000000000001
11111111111111111111111111111111
11111111111111111111111111111111
10000000000011011000000001010001
10000N00000000000000000001010001
10000000000000000000000000000101
10000000000000000000000000000001
100000000011101001110111110111111
11000001110101011111011110011
11110111 1110101 101111010001
11111111 1111111 11111111111